1 1 1 1 1 1 1 1 1 1 1 1 1 1 1 1 1 1
1 0 1 1 1 1 1 0 1 0 1 0 0 1 0 1 0 1
1 0 0 0 0 0 0 0 0 0 0 0 0 0 0 0 0 1
1 0 0 0 1 1 1 1 1 1 1 1 1 1 3 1 0 1
1 1 1 1 1 1 1 M 1 1 M 1 0 0 0 0 0 1
1 0 0 0 M 0 0 0 0 0 0 0 0 1 0 1 1 1
1 1 0 1 1 1 0 1 1 1 1 0 0 1 0 0 0 1
1 0 0 0 0 0 1 1 1 1 1 1 1 1 0 1 0 1
1 0 1 1 1 1 1 0 0 0 0 0 0 1 0 3 0 1
1 0 1 0 M 0 1 9 1 0 0 1 1 1 1 1 0 1
1 0 0 0 0 0 0 0 0 0 0 0 0 0 0 1 0 1
1 0 1 1 1 1 1 1 1 0 3 0 0 0 0 1 0 1
1 0 0 0 0 M 0 0 1 1 1 1 1 1 1 0 1 1
1 0 1 1 1 1 1 1 1 1 1 1 1 1 1 0 1 1
1 0 0 0 0 0 0 0 0 0 0 0 0 0 0 0 0 1
1 1 1 1 1 1 1 1 1 1 1 1 1 1 1 1 0 1
1 0 0 0 0 0 0 0 0 0 0 0 0 M 0 0 0 1
1 1 1 1 1 1 1 1 1 1 1 1 1 1 1 1 1 1