1 1 1 1 1 1 1 1 1 1 1 1 1 1 1 1 1 1
1 0 1 1 1 1 1 0 1 0 1 0 0 1 0 1 0 1
1 0 0 0 0 0 0 0 0 0 0 0 0 0 0 0 0 1
1 0 0 0 1 1 1 1 1 1 1 1 1 1 x 1 0 1
1 1 1 1 1 1 1 M 1 1 M 1 0 0 0 0 0 1
1 0 0 0 M 0 0 0 0 0 0 0 0 1 0 1 1 1
1 1 0 1 1 1 0 1 1 1 1 0 0 1 0 0 0 1
1 0 0 0 0 0 1 1 1 1 1 1 1 1 0 1 0 1
1 0 1 1 1 1 1 0 0 0 0 0 0 1 0 d 0 1
1 0 1 0 M 0 1 4 1 0 0 1 1 1 1 1 0 1
1 0 0 0 0 0 0 5 0 0 0 0 0 0 0 1 0 1
1 0 1 1 1 1 1 1 1 0 w 0 0 0 0 1 0 1
1 0 0 0 0 M 0 0 1 1 1 1 1 1 1 0 1 1
1 0 1 1 1 1 1 1 1 1 1 1 1 1 1 0 1 1
1 0 0 0 0 0 0 0 5 0 0 0 0 0 0 0 0 1
1 1 1 1 1 1 1 1 1 1 1 1 1 1 1 1 0 1
1 0 0 0 0 0 0 0 5 0 0 0 0 M 0 0 0 9
1 1 1 1 1 1 1 1 1 1 1 1 1 1 1 1 1 1