1 1 1 1 1 1 1 1 1 1 1 1 1 1 1 1 1 1
1 0 0 0 0 0 0 0 0 0 0 0 0 0 0 0 0 1
1 0 0 0 1 0 0 1 P 1 0 0 0 1 0 0 0 1
1 0 0 P 0 0 0 0 P 0 4 0 0 p P 0 0 1
1 0 1 0 p 0 0 0 M 0 0 5 p 0 0 1 0 1
1 0 0 0 0 p 0 0 P 0 0 p 0 0 0 0 0 1
1 0 0 0 0 0 p 0 p 0 p 0 0 6 6 0 0 1
1 0 1 0 0 0 0 p p p 0 0 0 0 0 1 0 1
1 0 P p p p p p x p p p p p p P 0 1
1 0 1 0 0 0 0 p p p 0 0 0 0 0 1 0 1
1 0 0 0 0 0 p 0 p 0 p 0 0 0 0 0 0 1
1 0 0 0 0 0 0 0 P 0 0 p 0 0 0 1 1 1
1 1 1 1 0 1 0 1 F 1 0 0 1 1 1 1 7 1
1 p p p P 0 0 1 8 1 0 0 1 p p 1 P 1
1 p p P p 1 0 1 8 1 0 0 p p p p p 1 
1 p L p p 1 0 1 F 1 0 0 0 1 p p p 1
1 e p p p 1 0 0 0 0 0 0 1 p p p q 1
1 1 9 1 1 1 1 1 1 1 1 1 1 1 1 1 1 1
