1 1 1 1 1 1 1 1 1 1 1 1 1 1 1 1 1 1
1 3 0 0 0 0 0 0 3 0 0 0 0 0 0 0 0 1
1 0 0 0 0 0 0 1 0 1 0 0 0 0 0 0 0 1
1 0 0 0 0 0 0 0 0 0 0 0 0 0 0 0 0 1
1 0 0 0 0 0 0 0 2 0 0 0 0 0 0 0 0 1
1 0 0 0 0 7 0 0 0 0 0 0 0 0 0 0 0 1
1 0 0 0 0 0 0 0 0 0 0 0 0 0 0 0 0 1
1 0 1 0 0 0 0 0 0 0 0 0 0 0 0 1 0 1
1 0 0 0 0 0 0 0 0 0 0 0 0 0 0 0 0 1
1 0 1 0 0 0 0 0 0 0 0 0 0 0 0 1 0 1
1 0 0 0 0 0 0 0 0 0 F 0 0 0 0 0 0 1
1 0 0 0 0 0 0 0 0 0 0 8 0 0 0 0 0 1
1 0 0 0 0 0 0 1 0 1 0 0 0 0 1 1 1 1
1 0 0 0 0 0 0 1 0 1 0 0 0 0 0 0 0 1
1 0 0 0 0 0 0 1 0 1 0 0 0 0 0 0 0 1
1 0 0 0 0 0 0 1 0 1 0 0 0 0 0 0 0 1
1 0 0 0 0 0 0 0 0 0 0 0 0 0 0 0 0 1
1 1 9 1 1 1 1 1 1 1 1 1 1 1 1 1 1 1
