1 0 1 1 1 1 1 1 1 1 1 1 1 1 1 1 1 1
1 0 1 1 1 1 1 0 1 0 1 0 0 1 0 1 0 1
1 0 0 0 0 0 0 0 1 0 1 0 0 1 0 0 0 9
1 0 0 0 1 1 1 0 1 0 1 0 0 1 3 1 0 1
1 1 1 1 1 1 1 0 1 1 1 1 0 1 0 1 1 1
1 0 0 0 2 0 0 0 1 0 1 0 0 1 0 1 0 1
1 1 0 1 1 1 0 1 1 1 1 0 0 1 0 0 0 1
1 0 0 0 0 0 0 1 1 1 1 1 1 1 0 1 0 1
1 0 q w e 1 1 0 0 0 0 0 0 0 0 3 0 1
1 0 a 2 d 0 1 1 1 0 0 1 1 1 1 1 0 1
1 0 y x c 0 0 0 0 0 0 0 0 0 0 0 0 1
1 0 1 1 1 1 1 1 1 0 3 0 0 0 0 0 0 1
1 0 0 0 0 2 0 0 1 1 1 1 1 1 1 0 1 1
1 1 1 1 1 1 1 1 1 1 1 1 1 1 1 0 1 1
1 0 0 0 0 0 0 0 0 0 0 0 0 0 0 0 0 1
1 1 1 1 1 1 1 1 1 1 1 1 1 1 1 1 0 1
1 0 0 0 0 0 0 0 0 0 0 0 0 2 0 0 0 1
1 1 0 1 1 1 1 1 1 1 1 1 1 1 1 1 1 1