1 1 1 1 1 1 1 1 1 1 1 1 1 1 1 1 1 1
1 0 0 0 0 0 0 0 0 0 0 0 0 0 0 0 p 1
1 1 1 1 1 0 0 1 1 1 1 1 1 1 1 0 p 1
1 0 1 0 1 p p p 0 0 0 0 0 0 1 0 p 1
1 0 0 0 1 p p p 1 1 1 1 1 1 1 p p 1
1 0 1 6 1 p p p p 1 0 0 M 0 0 p p 1
1 0 0 p p 4 p p p 1 0 1 1 1 1 p p 1
1 M 1 p p p p p a 6 0 0 1 0 0 p p 1
1 0 1 1 1 1 1 0 1 1 0 0 1 0 1 4 p 1
1 0 0 0 0 0 0 0 1 1 0 0 1 0 1 p w 1
1 p 1 1 M 1 1 0 1 1 1 1 1 0 1 1 1 1
1 p 0 0 0 0 1 1 1 1 1 x 1 0 0 0 0 1
1 p 1 0 0 0 0 0 0 0 1 p p p 1 1 0 1
1 p 0 6 1 1 1 0 0 0 1 p p p 1 0 0 1
1 p 1 p 1 0 1 0 0 0 1 p p 1 6 0 0 1 
1 p 1 p 1 0 1 0 1 1 1 p 1 1 1 1 1 1
1 w p p p 7 1 0 1 0 0 0 0 0 0 0 0 9
1 1 1 1 1 1 1 1 1 1 1 1 1 1 1 1 1 1
