1 1 1 1 1 1 1 1 1 1 1 1 1 1 1 1 1 1
1 0 0 0 0 0 0 0 0 0 0 0 0 0 0 0 0 1
1 0 0 0 0 0 0 1 C 1 0 0 0 0 0 0 0 1
1 0 0 C 0 0 0 0 0 0 0 0 0 0 C 0 0 1
1 0 0 0 0 0 0 0 2 0 0 0 0 0 0 0 0 1
1 0 0 0 0 7 0 0 0 0 0 0 0 0 0 0 0 1
1 0 0 0 0 0 0 0 0 0 0 0 0 0 0 0 0 1
1 0 1 0 0 0 0 0 0 0 0 0 0 0 0 1 0 1
1 0 C 0 0 0 0 0 3 0 0 0 0 0 0 C 0 1
1 0 1 0 0 0 0 0 0 0 0 0 0 0 0 1 0 1
1 0 0 0 0 0 0 0 0 0 0 0 0 0 0 0 0 1
1 0 0 0 0 0 0 0 C 0 0 8 0 0 0 0 0 1
1 0 0 0 0 0 0 1 F 1 0 0 0 0 1 1 1 1
1 0 0 0 0 0 0 1 8 1 0 0 0 0 0 0 0 1
1 C C C 0 0 0 1 8 1 0 0 0 0 C 0 0 1
1 C E C 0 0 0 1 F 1 0 0 0 0 0 0 0 1
1 C C C 0 0 0 0 0 0 0 0 0 0 0 0 0 1
1 1 9 1 1 1 1 1 1 1 1 1 1 1 1 1 1 1
